B7 B7 B7 B7 B7 B7 B7 B7
B7 B7 B7 B7 B7 B7 B7 B7
B6 B6 B6 B6 B6 B6 B6 B6
B5 B5 B5 B5 B5 B5 B5 B5
B4 B4 B4 B4 B4 B4 B4 B4
B3 B3 B3 B3 B3 B3 B3 B3
B2 B2 S2 G2 G2 B2 B2 B2
I1 I1 B1 B1 B1 S1 S1 B1