7B 7B 7B 7B 7B 7B 7B 7B
6B 6B 6B 6B 6B 6B 6B 6B
5B 5B 5B 5B 5B 5B 5B 5B
4B 4B 4B 4B 4B 4B 4B 4B
3B 3B 3B 3B 3B 3B 3B 3B
2B 2B 2B 2B 2B 2B 2B 2B
1B 1B 1B 1B 1B 1B 1B 1B